#########################################################################
#                                                                       #
#     &                                                                 #
#      @                                                                #
#    *                                                                  #
#      *                                                                #
#  &                                                                    #
#                                                                       #
#                                                                       #
#                                                                       #
#                                                                       #
#                                                                       #
#                                                                       #
#########################################################################