##########################
#                        #
#     &                  #
#      @                 #
#    *                   #
#      *                 #
#  &                     #
#                        #
#                        #
#                        #
#                        #
#                        #
#                        #
##########################