############
#    &  *  #
#  &       #
#     # @  #
#  & #*    #
#     # *  #
#     &    #
#     *    #
#          #
#          #
#          #
############