############
#          #
#     &    #
#      @   #
#    *     #
#      *   #
#  &       #
#          #
#          #
#          #
#          #
############