############
#       *  #
#  &   &   #
#    ## @  #
#  & #*    #
#    ## *  #
#  &    *  #
#          #
#          #
#          #
#          #
############