############
#          #
#  &   &   #
#    ## @  #
#    #*    #
#    ## *  #
#  &    *  #
#          #
############