#########################################################################
#                                                                       #
#     &                                                                 #
#                                                      &                #
#    *                                                    *             #
#      *                                                                #
#  &                                                                    #
#                                                        *              #
#                                                           &           #
#                                                                       #
#                                                                       #
#                                                                       #
#                                                                       #
#                                                                       #
#                                                                       #
#                                                                       #
#                                                                       #
#                                                                       #
#                                                                       #
#                                                                       #
#                                                                       #
#        @                                                              #
#########################################################################