############
#  #  &  * #
#  &       #
#     # @  #
#  &  *    #
#       *  #
#     &    #
#     *    #
#          #
#          #
#          #
############