#############################################################
#                                                           #
#     &                                                     #
#                                                      &    #
#    *                                                   *  #
#      *                                                    #
#  &                                                        #
#                                                        *  #
#                                               &           #
#                                                           #
#                                                           #
#                                                           #
#                                                           #
#                                                           #
#                                                           #
#                                                           #
#                                                           #
#                                                           #
#                                                           #
#                                                           #
#                                                           #
#   @                                                       #
#############################################################