#############################################################
#                                                           #
#     &                                                     #
#                                                      &    #
#    *                                                   *  #
#      *              ##                                    #
#  &                                                        #
#                                                        *  #
#                                               &           #
#                                                           #
#                                                           #
#                                                           #
#                                                           #
#                                                           #
#                                                           #
#                                                           #
#                                                           #
#                                                           #
#                                                           #
#                                                           #
#                                                           #
#                                                       @   #
#############################################################